"filename", "language", "JavaScript", "JSON", "wxml", "Less", "CSS", "comment", "blank", "total"
"e:\毕业设计相关\果帕雅微信小程序\.eslintrc.js", "JavaScript", 25, 0, 0, 0, 0, 6, 1, 32
"e:\毕业设计相关\果帕雅微信小程序\app.js", "JavaScript", 24, 0, 0, 0, 0, 6, 2, 32
"e:\毕业设计相关\果帕雅微信小程序\app.json", "JSON", 0, 103, 0, 0, 0, 0, 8, 111
"e:\毕业设计相关\果帕雅微信小程序\app.wxss", "CSS", 0, 0, 0, 0, 16, 3, 4, 23
"e:\毕业设计相关\果帕雅微信小程序\common\main.js", "JavaScript", 87, 0, 0, 0, 0, 28, 30, 145
"e:\毕业设计相关\果帕雅微信小程序\common\main.wxss", "CSS", 0, 0, 0, 0, 0, 1, 17, 18
"e:\毕业设计相关\果帕雅微信小程序\common\runtime.js", "JavaScript", 129, 0, 0, 0, 0, 27, 2, 158
"e:\毕业设计相关\果帕雅微信小程序\common\vendor.js", "JavaScript", 8025, 0, 0, 0, 0, 1237, 690, 9952
"e:\毕业设计相关\果帕雅微信小程序\components\Tabs\Tabs.js", "JavaScript", 16, 0, 0, 0, 0, 13, 4, 33
"e:\毕业设计相关\果帕雅微信小程序\components\Tabs\Tabs.json", "JSON", 0, 4, 0, 0, 0, 0, 0, 4
"e:\毕业设计相关\果帕雅微信小程序\components\Tabs\Tabs.wxml", "wxml", 0, 0, 16, 0, 0, 0, 3, 19
"e:\毕业设计相关\果帕雅微信小程序\components\Tabs\Tabs.wxss", "CSS", 0, 0, 0, 0, 16, 0, 1, 17
"e:\毕业设计相关\果帕雅微信小程序\components\UpImg\UpImg.js", "JavaScript", 12, 0, 0, 0, 0, 10, 5, 27
"e:\毕业设计相关\果帕雅微信小程序\components\UpImg\UpImg.json", "JSON", 0, 4, 0, 0, 0, 0, 0, 4
"e:\毕业设计相关\果帕雅微信小程序\components\UpImg\UpImg.wxml", "wxml", 0, 0, 9, 0, 0, 0, 4, 13
"e:\毕业设计相关\果帕雅微信小程序\components\UpImg\UpImg.wxss", "CSS", 0, 0, 0, 0, 15, 0, 0, 15
"e:\毕业设计相关\果帕雅微信小程序\components\find.js", "JavaScript", 8, 0, 0, 0, 0, 10, 6, 24
"e:\毕业设计相关\果帕雅微信小程序\components\find.json", "JSON", 0, 4, 0, 0, 0, 0, 0, 4
"e:\毕业设计相关\果帕雅微信小程序\components\find.less", "Less", 0, 0, 0, 37, 0, 0, 2, 39
"e:\毕业设计相关\果帕雅微信小程序\components\find.wxml", "wxml", 0, 0, 7, 0, 0, 0, 1, 8
"e:\毕业设计相关\果帕雅微信小程序\components\find.wxss", "CSS", 0, 0, 0, 0, 37, 0, 1, 38
"e:\毕业设计相关\果帕雅微信小程序\components\headerNav\headerNav.js", "JavaScript", 24, 0, 0, 0, 0, 10, 3, 37
"e:\毕业设计相关\果帕雅微信小程序\components\headerNav\headerNav.json", "JSON", 0, 4, 0, 0, 0, 0, 0, 4
"e:\毕业设计相关\果帕雅微信小程序\components\headerNav\headerNav.wxml", "wxml", 0, 0, 9, 0, 0, 0, 2, 11
"e:\毕业设计相关\果帕雅微信小程序\components\headerNav\headerNav.wxss", "CSS", 0, 0, 0, 0, 21, 2, 3, 26
"e:\毕业设计相关\果帕雅微信小程序\iconfont.json", "JSON", 0, 7, 0, 0, 0, 0, 1, 8
"e:\毕业设计相关\果帕雅微信小程序\iconfont\iconfont.js", "JavaScript", 55, 0, 0, 0, 0, 2, 7, 64
"e:\毕业设计相关\果帕雅微信小程序\iconfont\iconfont.json", "JSON", 0, 4, 0, 0, 0, 0, 1, 5
"e:\毕业设计相关\果帕雅微信小程序\iconfont\iconfont.wxml", "wxml", 0, 0, 45, 0, 0, 9, 10, 64
"e:\毕业设计相关\果帕雅微信小程序\iconfont\iconfont.wxss", "CSS", 0, 0, 0, 0, 3, 0, 1, 4
"e:\毕业设计相关\果帕雅微信小程序\lib\css\iconfont.wxss", "CSS", 0, 0, 0, 0, 42, 0, 11, 53
"e:\毕业设计相关\果帕雅微信小程序\lib\runtime\dayjs.js", "JavaScript", 1, 0, 0, 0, 0, 0, 0, 1
"e:\毕业设计相关\果帕雅微信小程序\lib\runtime\runtime.js", "JavaScript", 471, 0, 0, 0, 0, 129, 110, 710
"e:\毕业设计相关\果帕雅微信小程序\libs\citySelector\city.js", "JavaScript", 35, 0, 0, 0, 0, 6, 12, 53
"e:\毕业设计相关\果帕雅微信小程序\libs\citySelector\config.default.js", "JavaScript", 3, 0, 0, 0, 0, 1, 1, 5
"e:\毕业设计相关\果帕雅微信小程序\libs\citySelector\switchcity\switchcity.js", "JavaScript", 248, 0, 0, 0, 0, 41, 20, 309
"e:\毕业设计相关\果帕雅微信小程序\libs\citySelector\switchcity\switchcity.json", "JSON", 0, 3, 0, 0, 0, 0, 1, 4
"e:\毕业设计相关\果帕雅微信小程序\libs\citySelector\switchcity\switchcity.wxml", "wxml", 0, 0, 76, 0, 0, 0, 17, 93
"e:\毕业设计相关\果帕雅微信小程序\libs\citySelector\switchcity\switchcity.wxss", "CSS", 0, 0, 0, 0, 156, 0, 26, 182
"e:\毕业设计相关\果帕雅微信小程序\miniprogram_npm\qqmap-wx-jssdk\index.js", "JavaScript", 12, 0, 0, 0, 0, 2, 0, 14
"e:\毕业设计相关\果帕雅微信小程序\miniprogram_npm\weui-miniprogram\_commons\0.js", "JavaScript", 1, 0, 0, 0, 0, 0, 0, 1
"e:\毕业设计相关\果帕雅微信小程序\miniprogram_npm\weui-miniprogram\_commons\slideview.5abc910a.wxs", "JavaScript", 223, 0, 0, 0, 0, 21, 0, 244
"e:\毕业设计相关\果帕雅微信小程序\miniprogram_npm\weui-miniprogram\actionsheet\actionsheet.js", "JavaScript", 1, 0, 0, 0, 0, 0, 0, 1
"e:\毕业设计相关\果帕雅微信小程序\miniprogram_npm\weui-miniprogram\actionsheet\actionsheet.json", "JSON", 0, 4, 0, 0, 0, 0, 1, 5
"e:\毕业设计相关\果帕雅微信小程序\miniprogram_npm\weui-miniprogram\actionsheet\actionsheet.wxml", "wxml", 0, 0, 12, 0, 0, 0, 1, 13
"e:\毕业设计相关\果帕雅微信小程序\miniprogram_npm\weui-miniprogram\actionsheet\actionsheet.wxss", "CSS", 0, 0, 0, 0, 1, 0, 2, 3
"e:\毕业设计相关\果帕雅微信小程序\miniprogram_npm\weui-miniprogram\badge\badge.js", "JavaScript", 1, 0, 0, 0, 0, 0, 0, 1
"e:\毕业设计相关\果帕雅微信小程序\miniprogram_npm\weui-miniprogram\badge\badge.json", "JSON", 0, 4, 0, 0, 0, 0, 1, 5
"e:\毕业设计相关\果帕雅微信小程序\miniprogram_npm\weui-miniprogram\badge\badge.wxml", "wxml", 0, 0, 1, 0, 0, 0, 1, 2
"e:\毕业设计相关\果帕雅微信小程序\miniprogram_npm\weui-miniprogram\badge\badge.wxss", "CSS", 0, 0, 0, 0, 0, 0, 3, 3
"e:\毕业设计相关\果帕雅微信小程序\miniprogram_npm\weui-miniprogram\cell\cell.js", "JavaScript", 1, 0, 0, 0, 0, 0, 0, 1
"e:\毕业设计相关\果帕雅微信小程序\miniprogram_npm\weui-miniprogram\cell\cell.json", "JSON", 0, 6, 0, 0, 0, 0, 1, 7
"e:\毕业设计相关\果帕雅微信小程序\miniprogram_npm\weui-miniprogram\cell\cell.wxml", "wxml", 0, 0, 1, 0, 0, 0, 1, 2
"e:\毕业设计相关\果帕雅微信小程序\miniprogram_npm\weui-miniprogram\cell\cell.wxss", "CSS", 0, 0, 0, 0, 1, 0, 2, 3
"e:\毕业设计相关\果帕雅微信小程序\miniprogram_npm\weui-miniprogram\cells\cells.js", "JavaScript", 1, 0, 0, 0, 0, 0, 0, 1
"e:\毕业设计相关\果帕雅微信小程序\miniprogram_npm\weui-miniprogram\cells\cells.json", "JSON", 0, 4, 0, 0, 0, 0, 1, 5
"e:\毕业设计相关\果帕雅微信小程序\miniprogram_npm\weui-miniprogram\cells\cells.wxml", "wxml", 0, 0, 1, 0, 0, 0, 1, 2
"e:\毕业设计相关\果帕雅微信小程序\miniprogram_npm\weui-miniprogram\cells\cells.wxss", "CSS", 0, 0, 0, 0, 1, 0, 2, 3
"e:\毕业设计相关\果帕雅微信小程序\miniprogram_npm\weui-miniprogram\checkbox-group\checkbox-group.js", "JavaScript", 1, 0, 0, 0, 0, 0, 0, 1
"e:\毕业设计相关\果帕雅微信小程序\miniprogram_npm\weui-miniprogram\checkbox-group\checkbox-group.json", "JSON", 0, 6, 0, 0, 0, 0, 1, 7
"e:\毕业设计相关\果帕雅微信小程序\miniprogram_npm\weui-miniprogram\checkbox-group\checkbox-group.wxml", "wxml", 0, 0, 1, 0, 0, 0, 1, 2
"e:\毕业设计相关\果帕雅微信小程序\miniprogram_npm\weui-miniprogram\checkbox-group\checkbox-group.wxss", "CSS", 0, 0, 0, 0, 0, 0, 3, 3
"e:\毕业设计相关\果帕雅微信小程序\miniprogram_npm\weui-miniprogram\checkbox\checkbox.js", "JavaScript", 1, 0, 0, 0, 0, 0, 0, 1
"e:\毕业设计相关\果帕雅微信小程序\miniprogram_npm\weui-miniprogram\checkbox\checkbox.json", "JSON", 0, 7, 0, 0, 0, 0, 1, 8
"e:\毕业设计相关\果帕雅微信小程序\miniprogram_npm\weui-miniprogram\checkbox\checkbox.wxml", "wxml", 0, 0, 1, 0, 0, 0, 1, 2
"e:\毕业设计相关\果帕雅微信小程序\miniprogram_npm\weui-miniprogram\checkbox\checkbox.wxss", "CSS", 0, 0, 0, 0, 0, 0, 3, 3
"e:\毕业设计相关\果帕雅微信小程序\miniprogram_npm\weui-miniprogram\dialog\dialog.js", "JavaScript", 1, 0, 0, 0, 0, 0, 0, 1
"e:\毕业设计相关\果帕雅微信小程序\miniprogram_npm\weui-miniprogram\dialog\dialog.json", "JSON", 0, 4, 0, 0, 0, 0, 1, 5
"e:\毕业设计相关\果帕雅微信小程序\miniprogram_npm\weui-miniprogram\dialog\dialog.wxml", "wxml", 0, 0, 1, 0, 0, 0, 1, 2
"e:\毕业设计相关\果帕雅微信小程序\miniprogram_npm\weui-miniprogram\dialog\dialog.wxss", "CSS", 0, 0, 0, 0, 1, 0, 2, 3
"e:\毕业设计相关\果帕雅微信小程序\miniprogram_npm\weui-miniprogram\form-page\form-page.js", "JavaScript", 1, 0, 0, 0, 0, 0, 0, 1
"e:\毕业设计相关\果帕雅微信小程序\miniprogram_npm\weui-miniprogram\form-page\form-page.json", "JSON", 0, 4, 0, 0, 0, 0, 1, 5
"e:\毕业设计相关\果帕雅微信小程序\miniprogram_npm\weui-miniprogram\form-page\form-page.wxml", "wxml", 0, 0, 1, 0, 0, 0, 1, 2
"e:\毕业设计相关\果帕雅微信小程序\miniprogram_npm\weui-miniprogram\form-page\form-page.wxss", "CSS", 0, 0, 0, 0, 0, 0, 3, 3
"e:\毕业设计相关\果帕雅微信小程序\miniprogram_npm\weui-miniprogram\form\form.js", "JavaScript", 1, 0, 0, 0, 0, 0, 0, 1
"e:\毕业设计相关\果帕雅微信小程序\miniprogram_npm\weui-miniprogram\form\form.json", "JSON", 0, 4, 0, 0, 0, 0, 1, 5
"e:\毕业设计相关\果帕雅微信小程序\miniprogram_npm\weui-miniprogram\form\form.wxml", "wxml", 0, 0, 1, 0, 0, 0, 1, 2
"e:\毕业设计相关\果帕雅微信小程序\miniprogram_npm\weui-miniprogram\gallery\gallery.js", "JavaScript", 1, 0, 0, 0, 0, 0, 0, 1
"e:\毕业设计相关\果帕雅微信小程序\miniprogram_npm\weui-miniprogram\gallery\gallery.json", "JSON", 0, 4, 0, 0, 0, 0, 1, 5
"e:\毕业设计相关\果帕雅微信小程序\miniprogram_npm\weui-miniprogram\gallery\gallery.wxml", "wxml", 0, 0, 1, 0, 0, 0, 1, 2
"e:\毕业设计相关\果帕雅微信小程序\miniprogram_npm\weui-miniprogram\gallery\gallery.wxss", "CSS", 0, 0, 0, 0, 1, 0, 2, 3
"e:\毕业设计相关\果帕雅微信小程序\miniprogram_npm\weui-miniprogram\grids\grids.js", "JavaScript", 1, 0, 0, 0, 0, 0, 0, 1
"e:\毕业设计相关\果帕雅微信小程序\miniprogram_npm\weui-miniprogram\grids\grids.json", "JSON", 0, 4, 0, 0, 0, 0, 1, 5
"e:\毕业设计相关\果帕雅微信小程序\miniprogram_npm\weui-miniprogram\grids\grids.wxml", "wxml", 0, 0, 1, 0, 0, 0, 1, 2
"e:\毕业设计相关\果帕雅微信小程序\miniprogram_npm\weui-miniprogram\grids\grids.wxss", "CSS", 0, 0, 0, 0, 1, 0, 2, 3
"e:\毕业设计相关\果帕雅微信小程序\miniprogram_npm\weui-miniprogram\half-screen-dialog\half-screen-dialog.js", "JavaScript", 1, 0, 0, 0, 0, 0, 0, 1
"e:\毕业设计相关\果帕雅微信小程序\miniprogram_npm\weui-miniprogram\half-screen-dialog\half-screen-dialog.json", "JSON", 0, 4, 0, 0, 0, 0, 1, 5
"e:\毕业设计相关\果帕雅微信小程序\miniprogram_npm\weui-miniprogram\half-screen-dialog\half-screen-dialog.wxml", "wxml", 0, 0, 1, 0, 0, 0, 1, 2
"e:\毕业设计相关\果帕雅微信小程序\miniprogram_npm\weui-miniprogram\half-screen-dialog\half-screen-dialog.wxss", "CSS", 0, 0, 0, 0, 1, 0, 2, 3
"e:\毕业设计相关\果帕雅微信小程序\miniprogram_npm\weui-miniprogram\icon\icon.js", "JavaScript", 1, 0, 0, 0, 0, 0, 0, 1
"e:\毕业设计相关\果帕雅微信小程序\miniprogram_npm\weui-miniprogram\icon\icon.json", "JSON", 0, 4, 0, 0, 0, 0, 1, 5
"e:\毕业设计相关\果帕雅微信小程序\miniprogram_npm\weui-miniprogram\icon\icon.wxml", "wxml", 0, 0, 12, 0, 0, 0, 1, 13
"e:\毕业设计相关\果帕雅微信小程序\miniprogram_npm\weui-miniprogram\icon\icon.wxss", "CSS", 0, 0, 0, 0, 1, 0, 2, 3
"e:\毕业设计相关\果帕雅微信小程序\miniprogram_npm\weui-miniprogram\index.js", "JavaScript", 1, 0, 0, 0, 0, 0, 0, 1
"e:\毕业设计相关\果帕雅微信小程序\miniprogram_npm\weui-miniprogram\index.json", "JSON", 0, 25, 0, 0, 0, 0, 1, 26
"e:\毕业设计相关\果帕雅微信小程序\miniprogram_npm\weui-miniprogram\index.wxml", "wxml", 0, 0, 0, 0, 0, 0, 2, 2
"e:\毕业设计相关\果帕雅微信小程序\miniprogram_npm\weui-miniprogram\index.wxss", "CSS", 0, 0, 0, 0, 2, 4, 3, 9
"e:\毕业设计相关\果帕雅微信小程序\miniprogram_npm\weui-miniprogram\loading\loading.js", "JavaScript", 1, 0, 0, 0, 0, 0, 0, 1
"e:\毕业设计相关\果帕雅微信小程序\miniprogram_npm\weui-miniprogram\loading\loading.json", "JSON", 0, 4, 0, 0, 0, 0, 1, 5
"e:\毕业设计相关\果帕雅微信小程序\miniprogram_npm\weui-miniprogram\loading\loading.wxml", "wxml", 0, 0, 1, 0, 0, 0, 1, 2
"e:\毕业设计相关\果帕雅微信小程序\miniprogram_npm\weui-miniprogram\loading\loading.wxss", "CSS", 0, 0, 0, 0, 1, 0, 2, 3
"e:\毕业设计相关\果帕雅微信小程序\miniprogram_npm\weui-miniprogram\msg\msg.js", "JavaScript", 1, 0, 0, 0, 0, 0, 0, 1
"e:\毕业设计相关\果帕雅微信小程序\miniprogram_npm\weui-miniprogram\msg\msg.json", "JSON", 0, 4, 0, 0, 0, 0, 1, 5
"e:\毕业设计相关\果帕雅微信小程序\miniprogram_npm\weui-miniprogram\msg\msg.wxml", "wxml", 0, 0, 1, 0, 0, 0, 1, 2
"e:\毕业设计相关\果帕雅微信小程序\miniprogram_npm\weui-miniprogram\msg\msg.wxss", "CSS", 0, 0, 0, 0, 1, 0, 2, 3
"e:\毕业设计相关\果帕雅微信小程序\miniprogram_npm\weui-miniprogram\navigation-bar\navigation-bar.js", "JavaScript", 1, 0, 0, 0, 0, 0, 0, 1
"e:\毕业设计相关\果帕雅微信小程序\miniprogram_npm\weui-miniprogram\navigation-bar\navigation-bar.json", "JSON", 0, 4, 0, 0, 0, 0, 1, 5
"e:\毕业设计相关\果帕雅微信小程序\miniprogram_npm\weui-miniprogram\navigation-bar\navigation-bar.wxml", "wxml", 0, 0, 1, 0, 0, 0, 1, 2
"e:\毕业设计相关\果帕雅微信小程序\miniprogram_npm\weui-miniprogram\navigation-bar\navigation-bar.wxss", "CSS", 0, 0, 0, 0, 1, 0, 2, 3
"e:\毕业设计相关\果帕雅微信小程序\miniprogram_npm\weui-miniprogram\searchbar\searchbar.js", "JavaScript", 1, 0, 0, 0, 0, 0, 0, 1
"e:\毕业设计相关\果帕雅微信小程序\miniprogram_npm\weui-miniprogram\searchbar\searchbar.json", "JSON", 0, 7, 0, 0, 0, 0, 1, 8
"e:\毕业设计相关\果帕雅微信小程序\miniprogram_npm\weui-miniprogram\searchbar\searchbar.wxml", "wxml", 0, 0, 1, 0, 0, 0, 1, 2
"e:\毕业设计相关\果帕雅微信小程序\miniprogram_npm\weui-miniprogram\searchbar\searchbar.wxss", "CSS", 0, 0, 0, 0, 1, 0, 2, 3
"e:\毕业设计相关\果帕雅微信小程序\miniprogram_npm\weui-miniprogram\slideview\slideview.js", "JavaScript", 1, 0, 0, 0, 0, 0, 0, 1
"e:\毕业设计相关\果帕雅微信小程序\miniprogram_npm\weui-miniprogram\slideview\slideview.json", "JSON", 0, 4, 0, 0, 0, 0, 1, 5
"e:\毕业设计相关\果帕雅微信小程序\miniprogram_npm\weui-miniprogram\slideview\slideview.wxml", "wxml", 0, 0, 1, 0, 0, 0, 1, 2
"e:\毕业设计相关\果帕雅微信小程序\miniprogram_npm\weui-miniprogram\slideview\slideview.wxss", "CSS", 0, 0, 0, 0, 1, 0, 2, 3
"e:\毕业设计相关\果帕雅微信小程序\miniprogram_npm\weui-miniprogram\tabbar\tabbar.js", "JavaScript", 1, 0, 0, 0, 0, 0, 0, 1
"e:\毕业设计相关\果帕雅微信小程序\miniprogram_npm\weui-miniprogram\tabbar\tabbar.json", "JSON", 0, 6, 0, 0, 0, 0, 1, 7
"e:\毕业设计相关\果帕雅微信小程序\miniprogram_npm\weui-miniprogram\tabbar\tabbar.wxml", "wxml", 0, 0, 1, 0, 0, 0, 1, 2
"e:\毕业设计相关\果帕雅微信小程序\miniprogram_npm\weui-miniprogram\tabbar\tabbar.wxss", "CSS", 0, 0, 0, 0, 11, 0, 2, 13
"e:\毕业设计相关\果帕雅微信小程序\miniprogram_npm\weui-miniprogram\toptips\toptips.js", "JavaScript", 1, 0, 0, 0, 0, 0, 0, 1
"e:\毕业设计相关\果帕雅微信小程序\miniprogram_npm\weui-miniprogram\toptips\toptips.json", "JSON", 0, 4, 0, 0, 0, 0, 1, 5
"e:\毕业设计相关\果帕雅微信小程序\miniprogram_npm\weui-miniprogram\toptips\toptips.wxml", "wxml", 0, 0, 1, 0, 0, 0, 1, 2
"e:\毕业设计相关\果帕雅微信小程序\miniprogram_npm\weui-miniprogram\toptips\toptips.wxss", "CSS", 0, 0, 0, 0, 1, 0, 2, 3
"e:\毕业设计相关\果帕雅微信小程序\miniprogram_npm\weui-miniprogram\uploader\uploader.js", "JavaScript", 1, 0, 0, 0, 0, 0, 0, 1
"e:\毕业设计相关\果帕雅微信小程序\miniprogram_npm\weui-miniprogram\uploader\uploader.json", "JSON", 0, 6, 0, 0, 0, 0, 1, 7
"e:\毕业设计相关\果帕雅微信小程序\miniprogram_npm\weui-miniprogram\uploader\uploader.wxml", "wxml", 0, 0, 1, 0, 0, 0, 1, 2
"e:\毕业设计相关\果帕雅微信小程序\miniprogram_npm\weui-miniprogram\uploader\uploader.wxss", "CSS", 0, 0, 0, 0, 0, 0, 3, 3
"e:\毕业设计相关\果帕雅微信小程序\miniprogram_npm\weui-miniprogram\weui-wxss\dist\style\weui.wxss", "CSS", 0, 0, 0, 0, 2, 4, 3, 9
"e:\毕业设计相关\果帕雅微信小程序\package-lock.json", "JSON", 0, 525, 0, 0, 0, 0, 1, 526
"e:\毕业设计相关\果帕雅微信小程序\package.json", "JSON", 0, 21, 0, 0, 0, 0, 1, 22
"e:\毕业设计相关\果帕雅微信小程序\pages\aaaademo\index.js", "JavaScript", 458, 0, 0, 0, 0, 69, 2, 529
"e:\毕业设计相关\果帕雅微信小程序\pages\aaaademo\index.json", "JSON", 0, 3, 0, 0, 0, 0, 0, 3
"e:\毕业设计相关\果帕雅微信小程序\pages\aaaademo\index.wxml", "wxml", 0, 0, 136, 0, 0, 13, 5, 154
"e:\毕业设计相关\果帕雅微信小程序\pages\aaaademo\index.wxss", "CSS", 0, 0, 0, 0, 283, 2, 3, 288
"e:\毕业设计相关\果帕雅微信小程序\pages\cart\index.js", "JavaScript", 291, 0, 0, 0, 0, 104, 5, 400
"e:\毕业设计相关\果帕雅微信小程序\pages\cart\index.json", "JSON", 0, 4, 0, 0, 0, 0, 0, 4
"e:\毕业设计相关\果帕雅微信小程序\pages\cart\index.less", "Less", 0, 0, 0, 329, 0, 0, 30, 359
"e:\毕业设计相关\果帕雅微信小程序\pages\cart\index.wxml", "wxml", 0, 0, 148, 0, 0, 15, 7, 170
"e:\毕业设计相关\果帕雅微信小程序\pages\cart\index.wxss", "CSS", 0, 0, 0, 0, 319, 0, 1, 320
"e:\毕业设计相关\果帕雅微信小程序\pages\dianzan\index.js", "JavaScript", 70, 0, 0, 0, 0, 4, 7, 81
"e:\毕业设计相关\果帕雅微信小程序\pages\dianzan\index.json", "JSON", 0, 4, 0, 0, 0, 0, 0, 4
"e:\毕业设计相关\果帕雅微信小程序\pages\dianzan\index.wxml", "wxml", 0, 0, 45, 0, 0, 0, 5, 50
"e:\毕业设计相关\果帕雅微信小程序\pages\dianzan\index.wxss", "CSS", 0, 0, 0, 0, 72, 1, 1, 74
"e:\毕业设计相关\果帕雅微信小程序\pages\feedback\index.js", "JavaScript", 261, 0, 0, 0, 0, 36, 11, 308
"e:\毕业设计相关\果帕雅微信小程序\pages\feedback\index.json", "JSON", 0, 7, 0, 0, 0, 0, 1, 8
"e:\毕业设计相关\果帕雅微信小程序\pages\feedback\index.less", "Less", 0, 0, 0, 60, 0, 0, 7, 67
"e:\毕业设计相关\果帕雅微信小程序\pages\feedback\index.wxml", "wxml", 0, 0, 41, 0, 0, 0, 5, 46
"e:\毕业设计相关\果帕雅微信小程序\pages\feedback\index.wxss", "CSS", 0, 0, 0, 0, 58, 0, 1, 59
"e:\毕业设计相关\果帕雅微信小程序\pages\fenxiang\index.js", "JavaScript", 73, 0, 0, 0, 0, 4, 4, 81
"e:\毕业设计相关\果帕雅微信小程序\pages\fenxiang\index.json", "JSON", 0, 4, 0, 0, 0, 0, 0, 4
"e:\毕业设计相关\果帕雅微信小程序\pages\fenxiang\index.wxml", "wxml", 0, 0, 45, 0, 0, 0, 5, 50
"e:\毕业设计相关\果帕雅微信小程序\pages\fenxiang\index.wxss", "CSS", 0, 0, 0, 0, 72, 1, 1, 74
"e:\毕业设计相关\果帕雅微信小程序\pages\front_page\index.js", "JavaScript", 125, 0, 0, 0, 0, 8, 6, 139
"e:\毕业设计相关\果帕雅微信小程序\pages\front_page\index.json", "JSON", 0, 6, 0, 0, 0, 0, 0, 6
"e:\毕业设计相关\果帕雅微信小程序\pages\front_page\index.less", "Less", 0, 0, 0, 360, 0, 0, 28, 388
"e:\毕业设计相关\果帕雅微信小程序\pages\front_page\index.wxml", "wxml", 0, 0, 196, 0, 0, 37, 10, 243
"e:\毕业设计相关\果帕雅微信小程序\pages\front_page\index.wxss", "CSS", 0, 0, 0, 0, 356, 3, 1, 360
"e:\毕业设计相关\果帕雅微信小程序\pages\goods_detail\index.js", "JavaScript", 318, 0, 0, 0, 0, 35, 11, 364
"e:\毕业设计相关\果帕雅微信小程序\pages\goods_detail\index.json", "JSON", 0, 4, 0, 0, 0, 0, 0, 4
"e:\毕业设计相关\果帕雅微信小程序\pages\goods_detail\index.less", "Less", 0, 0, 0, 217, 0, 1, 10, 228
"e:\毕业设计相关\果帕雅微信小程序\pages\goods_detail\index.wxml", "wxml", 0, 0, 90, 0, 0, 25, 9, 124
"e:\毕业设计相关\果帕雅微信小程序\pages\goods_detail\index.wxss", "CSS", 0, 0, 0, 0, 212, 1, 1, 214
"e:\毕业设计相关\果帕雅微信小程序\pages\goods_detail\introduce\index.js", "JavaScript", 22, 0, 0, 0, 0, 0, 5, 27
"e:\毕业设计相关\果帕雅微信小程序\pages\goods_detail\introduce\index.json", "JSON", 0, 4, 0, 0, 0, 0, 0, 4
"e:\毕业设计相关\果帕雅微信小程序\pages\goods_detail\introduce\index.less", "Less", 0, 0, 0, 48, 0, 0, 2, 50
"e:\毕业设计相关\果帕雅微信小程序\pages\goods_detail\introduce\index.wxml", "wxml", 0, 0, 29, 0, 0, 0, 5, 34
"e:\毕业设计相关\果帕雅微信小程序\pages\goods_detail\introduce\index.wxss", "CSS", 0, 0, 0, 0, 44, 0, 1, 45
"e:\毕业设计相关\果帕雅微信小程序\pages\historySee\index.js", "JavaScript", 171, 0, 0, 0, 0, 8, 9, 188
"e:\毕业设计相关\果帕雅微信小程序\pages\historySee\index.json", "JSON", 0, 5, 0, 0, 0, 0, 0, 5
"e:\毕业设计相关\果帕雅微信小程序\pages\historySee\index.wxml", "wxml", 0, 0, 71, 0, 0, 6, 6, 83
"e:\毕业设计相关\果帕雅微信小程序\pages\historySee\index.wxss", "CSS", 0, 0, 0, 0, 134, 1, 0, 135
"e:\毕业设计相关\果帕雅微信小程序\pages\index\index.js", "JavaScript", 20, 0, 0, 0, 0, 28, 18, 66
"e:\毕业设计相关\果帕雅微信小程序\pages\index\index.wxml", "wxml", 0, 0, 1, 0, 0, 1, 1, 3
"e:\毕业设计相关\果帕雅微信小程序\pages\login\index.js", "JavaScript", 102, 0, 0, 0, 0, 12, 7, 121
"e:\毕业设计相关\果帕雅微信小程序\pages\login\index.json", "JSON", 0, 4, 0, 0, 0, 0, 0, 4
"e:\毕业设计相关\果帕雅微信小程序\pages\login\index.wxml", "wxml", 0, 0, 1, 0, 0, 1, 2, 4
"e:\毕业设计相关\果帕雅微信小程序\pages\login\index.wxss", "CSS", 0, 0, 0, 0, 4, 1, 0, 5
"e:\毕业设计相关\果帕雅微信小程序\pages\nation_treat1\index.js", "JavaScript", 41, 0, 0, 0, 0, 18, 7, 66
"e:\毕业设计相关\果帕雅微信小程序\pages\nation_treat1\index.json", "JSON", 0, 3, 0, 0, 0, 0, 0, 3
"e:\毕业设计相关\果帕雅微信小程序\pages\nation_treat1\index.less", "Less", 0, 0, 0, 52, 0, 3, 1, 56
"e:\毕业设计相关\果帕雅微信小程序\pages\nation_treat1\index.wxml", "wxml", 0, 0, 46, 0, 0, 2, 2, 50
"e:\毕业设计相关\果帕雅微信小程序\pages\nation_treat1\index.wxss", "CSS", 0, 0, 0, 0, 48, 3, 1, 52
"e:\毕业设计相关\果帕雅微信小程序\pages\nation_treat\index.js", "JavaScript", 174, 0, 0, 0, 0, 13, 5, 192
"e:\毕业设计相关\果帕雅微信小程序\pages\nation_treat\index.json", "JSON", 0, 6, 0, 0, 0, 0, 0, 6
"e:\毕业设计相关\果帕雅微信小程序\pages\nation_treat\index.less", "Less", 0, 0, 0, 82, 0, 0, 5, 87
"e:\毕业设计相关\果帕雅微信小程序\pages\nation_treat\index.wxml", "wxml", 0, 0, 174, 0, 0, 13, 6, 193
"e:\毕业设计相关\果帕雅微信小程序\pages\nation_treat\index.wxss", "CSS", 0, 0, 0, 0, 70, 0, 1, 71
"e:\毕业设计相关\果帕雅微信小程序\pages\nation_treat\show\index.js", "JavaScript", 68, 0, 0, 0, 0, 4, 7, 79
"e:\毕业设计相关\果帕雅微信小程序\pages\nation_treat\show\index.json", "JSON", 0, 5, 0, 0, 0, 0, 1, 6
"e:\毕业设计相关\果帕雅微信小程序\pages\nation_treat\show\index.less", "Less", 0, 0, 0, 81, 0, 0, 2, 83
"e:\毕业设计相关\果帕雅微信小程序\pages\nation_treat\show\index.wxml", "wxml", 0, 0, 40, 0, 0, 0, 4, 44
"e:\毕业设计相关\果帕雅微信小程序\pages\nation_treat\show\index.wxss", "CSS", 0, 0, 0, 0, 81, 0, 1, 82
"e:\毕业设计相关\果帕雅微信小程序\pages\news\index.js", "JavaScript", 32, 0, 0, 0, 0, 1, 1, 34
"e:\毕业设计相关\果帕雅微信小程序\pages\news\index.json", "JSON", 0, 4, 0, 0, 0, 0, 0, 4
"e:\毕业设计相关\果帕雅微信小程序\pages\news\index.wxml", "wxml", 0, 0, 15, 0, 0, 1, 2, 18
"e:\毕业设计相关\果帕雅微信小程序\pages\news\index.wxss", "CSS", 0, 0, 0, 0, 36, 2, 6, 44
"e:\毕业设计相关\果帕雅微信小程序\pages\news\new_detail\index.js", "JavaScript", 19, 0, 0, 0, 0, 0, 0, 19
"e:\毕业设计相关\果帕雅微信小程序\pages\news\new_detail\index.json", "JSON", 0, 4, 0, 0, 0, 0, 0, 4
"e:\毕业设计相关\果帕雅微信小程序\pages\news\new_detail\index.wxml", "wxml", 0, 0, 22, 0, 0, 0, 4, 26
"e:\毕业设计相关\果帕雅微信小程序\pages\news\new_detail\index.wxss", "CSS", 0, 0, 0, 0, 33, 0, 0, 33
"e:\毕业设计相关\果帕雅微信小程序\pages\p_video\index.js", "JavaScript", 370, 0, 0, 0, 0, 306, 57, 733
"e:\毕业设计相关\果帕雅微信小程序\pages\p_video\index.json", "JSON", 0, 4, 0, 0, 0, 0, 0, 4
"e:\毕业设计相关\果帕雅微信小程序\pages\p_video\index.wxml", "wxml", 0, 0, 68, 0, 0, 0, 3, 71
"e:\毕业设计相关\果帕雅微信小程序\pages\p_video\index.wxss", "CSS", 0, 0, 0, 0, 104, 5, 6, 115
"e:\毕业设计相关\果帕雅微信小程序\pages\payDetail\addressChoose\index.js", "JavaScript", 60, 0, 0, 0, 0, 7, 2, 69
"e:\毕业设计相关\果帕雅微信小程序\pages\payDetail\addressChoose\index.json", "JSON", 0, 3, 0, 0, 0, 0, 0, 3
"e:\毕业设计相关\果帕雅微信小程序\pages\payDetail\addressChoose\index.less", "Less", 0, 0, 0, 54, 0, 2, 3, 59
"e:\毕业设计相关\果帕雅微信小程序\pages\payDetail\addressChoose\index.wxml", "wxml", 0, 0, 28, 0, 0, 2, 4, 34
"e:\毕业设计相关\果帕雅微信小程序\pages\payDetail\addressChoose\index.wxss", "CSS", 0, 0, 0, 0, 53, 0, 1, 54
"e:\毕业设计相关\果帕雅微信小程序\pages\payDetail\dingdan\index.js", "JavaScript", 19, 0, 0, 0, 0, 1, 5, 25
"e:\毕业设计相关\果帕雅微信小程序\pages\payDetail\dingdan\index.json", "JSON", 0, 4, 0, 0, 0, 0, 0, 4
"e:\毕业设计相关\果帕雅微信小程序\pages\payDetail\dingdan\index.less", "Less", 0, 0, 0, 53, 0, 0, 1, 54
"e:\毕业设计相关\果帕雅微信小程序\pages\payDetail\dingdan\index.wxml", "wxml", 0, 0, 17, 0, 0, 0, 3, 20
"e:\毕业设计相关\果帕雅微信小程序\pages\payDetail\dingdan\index.wxss", "CSS", 0, 0, 0, 0, 53, 0, 1, 54
"e:\毕业设计相关\果帕雅微信小程序\pages\payDetail\index.js", "JavaScript", 237, 0, 0, 0, 0, 14, 8, 259
"e:\毕业设计相关\果帕雅微信小程序\pages\payDetail\index.json", "JSON", 0, 6, 0, 0, 0, 0, 0, 6
"e:\毕业设计相关\果帕雅微信小程序\pages\payDetail\index.less", "Less", 0, 0, 0, 157, 0, 0, 6, 163
"e:\毕业设计相关\果帕雅微信小程序\pages\payDetail\index.wxml", "wxml", 0, 0, 108, 0, 0, 3, 21, 132
"e:\毕业设计相关\果帕雅微信小程序\pages\payDetail\index.wxss", "CSS", 0, 0, 0, 0, 157, 0, 1, 158
"e:\毕业设计相关\果帕雅微信小程序\pages\search\index.js", "JavaScript", 58, 0, 0, 0, 0, 12, 1, 71
"e:\毕业设计相关\果帕雅微信小程序\pages\search\index.json", "JSON", 0, 4, 0, 0, 0, 0, 0, 4
"e:\毕业设计相关\果帕雅微信小程序\pages\search\index.less", "Less", 0, 0, 0, 39, 0, 0, 2, 41
"e:\毕业设计相关\果帕雅微信小程序\pages\search\index.wxml", "wxml", 0, 0, 18, 0, 0, 0, 4, 22
"e:\毕业设计相关\果帕雅微信小程序\pages\search\index.wxss", "CSS", 0, 0, 0, 0, 39, 0, 1, 40
"e:\毕业设计相关\果帕雅微信小程序\pages\setup\addressEdit1\index.js", "JavaScript", 238, 0, 0, 0, 0, 25, 5, 268
"e:\毕业设计相关\果帕雅微信小程序\pages\setup\addressEdit1\index.json", "JSON", 0, 7, 0, 0, 0, 0, 0, 7
"e:\毕业设计相关\果帕雅微信小程序\pages\setup\addressEdit1\index.less", "Less", 0, 0, 0, 128, 0, 2, 5, 135
"e:\毕业设计相关\果帕雅微信小程序\pages\setup\addressEdit1\index.wxml", "wxml", 0, 0, 68, 0, 0, 0, 3, 71
"e:\毕业设计相关\果帕雅微信小程序\pages\setup\addressEdit1\index.wxss", "CSS", 0, 0, 0, 0, 126, 0, 1, 127
"e:\毕业设计相关\果帕雅微信小程序\pages\setup\addressEdit\index.js", "JavaScript", 17, 0, 0, 0, 0, 1, 8, 26
"e:\毕业设计相关\果帕雅微信小程序\pages\setup\addressEdit\index.json", "JSON", 0, 4, 0, 0, 0, 0, 0, 4
"e:\毕业设计相关\果帕雅微信小程序\pages\setup\addressEdit\index.less", "Less", 0, 0, 0, 0, 0, 0, 1, 1
"e:\毕业设计相关\果帕雅微信小程序\pages\setup\addressEdit\index.wxml", "wxml", 0, 0, 0, 0, 0, 0, 3, 3
"e:\毕业设计相关\果帕雅微信小程序\pages\setup\addressEdit\index.wxss", "CSS", 0, 0, 0, 0, 0, 0, 1, 1
"e:\毕业设计相关\果帕雅微信小程序\pages\setup\address\index.js", "JavaScript", 193, 0, 0, 0, 0, 29, 16, 238
"e:\毕业设计相关\果帕雅微信小程序\pages\setup\address\index.json", "JSON", 0, 4, 0, 0, 0, 0, 0, 4
"e:\毕业设计相关\果帕雅微信小程序\pages\setup\address\index.less", "Less", 0, 0, 0, 59, 0, 4, 5, 68
"e:\毕业设计相关\果帕雅微信小程序\pages\setup\address\index.wxml", "wxml", 0, 0, 51, 0, 0, 3, 4, 58
"e:\毕业设计相关\果帕雅微信小程序\pages\setup\address\index.wxss", "CSS", 0, 0, 0, 0, 59, 1, 1, 61
"e:\毕业设计相关\果帕雅微信小程序\pages\setup\index.js", "JavaScript", 40, 0, 0, 0, 0, 10, 6, 56
"e:\毕业设计相关\果帕雅微信小程序\pages\setup\index.json", "JSON", 0, 4, 0, 0, 0, 0, 0, 4
"e:\毕业设计相关\果帕雅微信小程序\pages\setup\index.less", "Less", 0, 0, 0, 78, 0, 0, 5, 83
"e:\毕业设计相关\果帕雅微信小程序\pages\setup\index.wxml", "wxml", 0, 0, 23, 0, 0, 2, 3, 28
"e:\毕业设计相关\果帕雅微信小程序\pages\setup\index.wxss", "CSS", 0, 0, 0, 0, 76, 0, 1, 77
"e:\毕业设计相关\果帕雅微信小程序\pages\shouchang\index.js", "JavaScript", 73, 0, 0, 0, 0, 4, 4, 81
"e:\毕业设计相关\果帕雅微信小程序\pages\shouchang\index.json", "JSON", 0, 4, 0, 0, 0, 0, 0, 4
"e:\毕业设计相关\果帕雅微信小程序\pages\shouchang\index.wxml", "wxml", 0, 0, 45, 0, 0, 0, 5, 50
"e:\毕业设计相关\果帕雅微信小程序\pages\shouchang\index.wxss", "CSS", 0, 0, 0, 0, 72, 1, 1, 74
"e:\毕业设计相关\果帕雅微信小程序\pages\text1\index.js", "JavaScript", 11, 0, 0, 0, 0, 0, 4, 15
"e:\毕业设计相关\果帕雅微信小程序\pages\text1\index.json", "JSON", 0, 5, 0, 0, 0, 0, 0, 5
"e:\毕业设计相关\果帕雅微信小程序\pages\text1\index.less", "Less", 0, 0, 0, 11, 0, 0, 1, 12
"e:\毕业设计相关\果帕雅微信小程序\pages\text1\index.wxml", "wxml", 0, 0, 7, 0, 0, 1, 2, 10
"e:\毕业设计相关\果帕雅微信小程序\pages\text1\index.wxss", "CSS", 0, 0, 0, 0, 14, 0, 1, 15
"e:\毕业设计相关\果帕雅微信小程序\pages\text2\index.js", "JavaScript", 370, 0, 0, 0, 0, 306, 57, 733
"e:\毕业设计相关\果帕雅微信小程序\pages\text2\index.json", "JSON", 0, 3, 0, 0, 0, 0, 0, 3
"e:\毕业设计相关\果帕雅微信小程序\pages\text2\index.wxml", "wxml", 0, 0, 68, 0, 0, 0, 3, 71
"e:\毕业设计相关\果帕雅微信小程序\pages\text2\index.wxss", "CSS", 0, 0, 0, 0, 104, 5, 6, 115
"e:\毕业设计相关\果帕雅微信小程序\pages\text3\index.js", "JavaScript", 122, 0, 0, 0, 0, 2, 7, 131
"e:\毕业设计相关\果帕雅微信小程序\pages\text3\index.json", "JSON", 0, 3, 0, 0, 0, 0, 0, 3
"e:\毕业设计相关\果帕雅微信小程序\pages\text3\index.less", "Less", 0, 0, 0, 58, 0, 6, 1, 65
"e:\毕业设计相关\果帕雅微信小程序\pages\text3\index.wxml", "wxml", 0, 0, 32, 0, 0, 0, 3, 35
"e:\毕业设计相关\果帕雅微信小程序\pages\text3\index.wxss", "CSS", 0, 0, 0, 0, 46, 1, 5, 52
"e:\毕业设计相关\果帕雅微信小程序\pages\text\index.js", "JavaScript", 39, 0, 0, 0, 0, 2, 2, 43
"e:\毕业设计相关\果帕雅微信小程序\pages\text\index.json", "JSON", 0, 6, 0, 0, 0, 0, 0, 6
"e:\毕业设计相关\果帕雅微信小程序\pages\text\index.less", "Less", 0, 0, 0, 134, 0, 0, 13, 147
"e:\毕业设计相关\果帕雅微信小程序\pages\text\index.wxml", "wxml", 0, 0, 7, 0, 0, 0, 8, 15
"e:\毕业设计相关\果帕雅微信小程序\pages\text\index.wxss", "CSS", 0, 0, 0, 0, 12, 0, 1, 13
"e:\毕业设计相关\果帕雅微信小程序\pages\user\index.js", "JavaScript", 160, 0, 0, 0, 0, 9, 7, 176
"e:\毕业设计相关\果帕雅微信小程序\pages\user\index.json", "JSON", 0, 4, 0, 0, 0, 0, 0, 4
"e:\毕业设计相关\果帕雅微信小程序\pages\user\index.less", "Less", 0, 0, 0, 505, 0, 5, 11, 521
"e:\毕业设计相关\果帕雅微信小程序\pages\user\index.wxml", "wxml", 0, 0, 224, 0, 0, 36, 9, 269
"e:\毕业设计相关\果帕雅微信小程序\pages\user\index.wxss", "CSS", 0, 0, 0, 0, 491, 0, 1, 492
"e:\毕业设计相关\果帕雅微信小程序\pages\user\order\index.js", "JavaScript", 191, 0, 0, 0, 0, 18, 9, 218
"e:\毕业设计相关\果帕雅微信小程序\pages\user\order\index.json", "JSON", 0, 4, 0, 0, 0, 0, 1, 5
"e:\毕业设计相关\果帕雅微信小程序\pages\user\order\index.wxml", "wxml", 0, 0, 261, 0, 0, 0, 11, 272
"e:\毕业设计相关\果帕雅微信小程序\pages\user\order\index.wxss", "CSS", 0, 0, 0, 0, 155, 2, 4, 161
"e:\毕业设计相关\果帕雅微信小程序\pages\yangsheng1\index.js", "JavaScript", 49, 0, 0, 0, 0, 5, 3, 57
"e:\毕业设计相关\果帕雅微信小程序\pages\yangsheng1\index.json", "JSON", 0, 5, 0, 0, 0, 0, 2, 7
"e:\毕业设计相关\果帕雅微信小程序\pages\yangsheng1\index.less", "Less", 0, 0, 0, 84, 0, 2, 1, 87
"e:\毕业设计相关\果帕雅微信小程序\pages\yangsheng1\index.wxml", "wxml", 0, 0, 15, 0, 0, 0, 4, 19
"e:\毕业设计相关\果帕雅微信小程序\pages\yangsheng1\index.wxss", "CSS", 0, 0, 0, 0, 82, 7, 1, 90
"e:\毕业设计相关\果帕雅微信小程序\pages\yangsheng\index.js", "JavaScript", 148, 0, 0, 0, 0, 16, 5, 169
"e:\毕业设计相关\果帕雅微信小程序\pages\yangsheng\index.json", "JSON", 0, 4, 0, 0, 0, 0, 0, 4
"e:\毕业设计相关\果帕雅微信小程序\pages\yangsheng\index.wxml", "wxml", 0, 0, 51, 0, 0, 5, 7, 63
"e:\毕业设计相关\果帕雅微信小程序\pages\yangsheng\index.wxss", "CSS", 0, 0, 0, 0, 159, 45, 11, 215
"e:\毕业设计相关\果帕雅微信小程序\project.config.json", "JSON", 0, 72, 0, 0, 0, 0, 0, 72
"e:\毕业设计相关\果帕雅微信小程序\project.private.config.json", "JSON", 0, 212, 0, 0, 0, 0, 0, 212
"e:\毕业设计相关\果帕雅微信小程序\request\index.js", "JavaScript", 14, 0, 0, 0, 0, 1, 4, 19
"e:\毕业设计相关\果帕雅微信小程序\sitemap.json", "JSON", 0, 7, 0, 0, 0, 0, 0, 7
"e:\毕业设计相关\果帕雅微信小程序\utils\asyncWx.js", "JavaScript", 103, 0, 0, 0, 0, 27, 9, 139
"e:\毕业设计相关\果帕雅微信小程序\utils\qqmap-wx-jssdk1.2\qqmap-wx-jssdk.js", "JavaScript", 874, 0, 0, 0, 0, 177, 72, 1123
"e:\毕业设计相关\果帕雅微信小程序\utils\qqmap-wx-jssdk1.2\qqmap-wx-jssdk.min.js", "JavaScript", 1, 0, 0, 0, 0, 0, 0, 1
"e:\毕业设计相关\果帕雅微信小程序\utils\touch.js", "JavaScript", 44, 0, 0, 0, 0, 4, 7, 55
"e:\毕业设计相关\果帕雅微信小程序\utils\util.js", "JavaScript", 16, 0, 0, 0, 0, 0, 4, 20
"Total", "-", 15113, 1238, 2396, 2626, 3959, 3165, 1899, 30396